   ########################################################################################
         #        #           #  #  #     #     #        #  #  #                          #
####  ##########  ####  ####  #  #  #  #  #  #  #  ####  #  #  #  ####  ####  ##########  #
#     #  #  #     #        #        #  #     #  #  #     #           #     #  #  #  #     #
####  #  #  ####  #############  ####  #######  #  ####  ####  #  #  #  #  #  #  #  #######
#  #     #        #  #              #  #  #           #     #  #  #  #  #  #     #        #
#  #  #  ####  #  #  ##########  #  #  #  ####  ##########  #  ################  #  #  ####
#  #  #  #     #        #        #  #     #           #  #        #  #     #     #  #     #
#  #  #######  ####  #  ####  #######  #######  #######  #  #######  #  #  ####  #  ####  #
#  #           #  #  #     #     #     #  #        #  #  #     #        #        #  #     #
#  #  #  #######  ########## B#######  #  #######  #  #  #######  #  ##########  #  #  ####
#     #     #     #     #  #     #     #        #     #  #  #  #  #  #  #     #     #     #
#  #  ##########  #  ####  ####  ####  ####  #  #  #  #  #  #  #  #  #  #  #  ####  ####  #
#  #  #           #                       #  #     #           #  #        #  #        #  #
####  #  #######  #  ####  ####  ##########  #######  ####  ###################  ##########
#     #        #        #  #        #     #  #  #  #  #     #                 #  #        #
####  ####  #######  ####  #############  ####  #  #  #  #  #  ##########  #  #  #  #######
#  #  #  #  #        #     #  #  #        #           #  #        #     #  #  #        #  #
#  #  #  #  #  #######  #  #  #  ####  #  ##########  #######  ####  ##########  ####  #  #
#           #        #  #  #           #  #  #     #     #  #     #  #  #           #     #
#  ##########  #  #######  #  #######  ####  #  #  #  #  #  #  ####  #  #  #  #  #######  #
#     #        #        #           #  #  #     #     #  #           #  #  #  #  #        #
#  #  #  #######  #######  ####  #######  #  #########################  #######  ####  ####
#  #  #  #  #           #  #              #     #              #  #     #     #  #        #
#  ####  #  ####  #  #############  #  ####  #  #############  #  #  #  #  ################
#     #     #  #  #  #        #     #  #  #  #  #     #     #     #  #  #     #  #        #
#  #  ####  #  ####  ####  #############  ####  #  ####  ####  #  #  #######  #  #######  #
#  #  #     #        #           #        #  #        #  #     #  #  #  #        #     #  #
####  ##########  ####  #  ####  ####  #  #  #  ####  #  #  #  #  #  #  #  #  ####  #  #  #
#        #              #     #  #     #           #        #  #  #     #  #        #  #  #
#  #  #  ####  #######  #  ####  #  #  ##########  #  #  #######  #  #######  #######  #  #
#  #  #     #     #     #     #  #  #     #        #  #     #                       #
########################################################################################  A
