###                   #########
#    ####################   # #
# ####                  # # # #
#  #################### # # # #
#                       # # # #
######################  # # # #
#   ##                  # # # #
# # ## ### ## ########### # # #
# #    #   ##B#           # # #
# # ## ################## # # #
### ##               #### # # #
### ################ ## # # # #
###               ##    # # # #
###### ########## ####### # # #
###### ####               #   #
A       #######################
