######B#
###### #
#####  #
##### ##
      ##
A#######